WE./textures/we.png
NO  ./textures/no.png
SO ./textures/so.png
EA ./textures/ea.png
F 300,100,0
C 100,200,255
1111111
1000001
100N001
1000001
1111111
