WE./textures/we.png
NO  ./textures/no.png
SO ./textures/so.png
EA ./textures/ea.png
F 255,100,0
C 100,200,255
1111111
1001001
111N101
1001001
1111111
