WE./textures/we.png
NO  ./textures/no.png
SO ./textures/so.png
EA ./textures/ea.png
F 255,100,0
C 100,200,255
1111111
1000001
1000001N
1000001
1111111
