C 255,0,0

F 0,010,255


             WE./textures/we.png
NO  ./textures/no.png
SO ./textures/so.png
EA ./textures/ea.png


111
10111111111
10100000011
100100001
101N1111
10010101111
101111011101
101 1000111
101  1111111
1011  
10111
10001
11111
