C 100,0,255
F 0,255,50
			WE ./textures/we.png
NO  ./textures/no.png

SO ./textures/so.png

EA ./textures/ea.png

111
11111111111
110000011
1111W0111
1010011111
1011000101
101110011111
101 1000111
101  11111111
1011  111
10111
10101
1111
